MODE 0
SIZE 9/9
LIMIT 1/90
COLOR LIMIT 5
STARS 700/1200/2100
GETSTARS 3
00 00 00 00 10 00 00 00 00
00 00 00 10 10 10 00 00 00
00 00 00 10 10 10 00 00 00
00 00 10 10 10 10 10 00 00
00 00 10 10 10 10 10 00 00
00 10 10 10 10 10 10 10 00
00 10 10 10 10 10 10 10 00
10 10 10 10 10 10 10 10 10
10 10 10 10 10 10 10 10 10